################################################################################
################################################################################
################################################################################
################################################################################
################################################################################
################################################################################
################################################################################
################################################################################
################################################################################
################################################################################
##########      #####          #################################################
########          ###          ####        #####        ########################
########          ###          ####        #####        ########################
########                                                ########################
########          ###          ####        #####        ########################
##########      #####          #################################################
############# ############ #####################################################
############# ############ #####################################################
############# ############ #####################################################
############# ############ #####################################################
############# ############ #####################################################
############# ############ #####################################################
############# ##########    ####################################################
############# #######          ######    #######################################
########          ###          #####      ######################################
########          ###          #####      ######################################
########                                  ######################################
########          ###          #####      ######################################
#####################          ######    #######################################
########################    ########### ########################################
########################## ############ ########################################
########################## ############ ########################################
########################## ############ ########################################
########################## ############ ########################################
###########    #########    ########### ########################################
##########      ########    ########### ########        #####        ###########
##########      ########    ########      ######        #####        ###########
##########      ########    ########      ######        #####        ###########
##########      ########    ########      ######        #####        ###########
##########                  ########                                 ###########
##########      ########    ########      ######        #####        ###########
##########      ########    ########      ######        #####        ###########
##########      ########    ####################        #####        ###########
###########    #########    ######################## ###########################
############# ############ ######################### ###########################
############# ############ ######################### ###########################
############# ############ ######################### ###########################
########          ###          ##################### ###########################
########          ###          ####        #####        ########################
########          ###          ####        #####        ########################
########          ###          ####        #####        ########################
########          ###          ####        #####        ########################
########                                                ########################
########          ###          ####        #####        ########################
########          ###          ####        #####        ########################
########          ###          ####        #####        ########################
########          ###          #################################################
################################################################################
################################################################################
################################################################################
################################################################################
################################################################################
################################################################################
################################################################################
################################################################################
################################################################################
################################################################################
################################################################################
################################################################################

