################################################################################
# #  #  ####   #       #       #       # ##  # ##      #### # #    # # ##     ##
# ###   # ###      # ##  #   ##    ### # # #      #  #        ##### ## ####    #
# # # # # #  #  ### #  ###   ## ## # #  # #    #      #     # ## ##       #    #
#   # #       #   # #   ##  ###   # #   ###       ######     ##   #   ### ##  ##
## # # #   #     #  #  ## ##       #  #    #  ##     #  ##     #   #        ## #
#     ##  ##   ### ### #    #   ## #   #   ### #    ##  #  ## ##   ##   # # #  #
###  #          #  #### ####    ##   ##    #    # ## ## ##  #   # # #   ##     #
# #  ## ##          #   #   ####     #  ####  #    #      #   #  #  ### #  #   #
#  ##  #     ## #    ##   ## ###  ##  ## #  ###  ## #   #  # ## ##  #      ##  #
###   #  #   ## ##  # #   #  #  #    # #   # #  # ## ###  ##       ###   #    ##
#  ###    ####  # ##    # # # #### ## # #     # #     # ###         #   ##   # #
#  ##   ###  # #      ## # ## ### # ### #    ##  #     #  #####   ##    ##  #  #
#  # #      # # ###      # #### # #   # # # # #  ##   # #  ##### #  #### # # # #
#  # ##    #  # ###### # #  ##      # ##  #  ## ##   # ###  #  #       ##     ##
#    # ##  ## # #   ##   #       #  #  ##  ## #   #    ##    #####      #### # #
# #        #  ## #   #     # #  ###  # # #       #   ##   # #  ##    ##   #    #
##  #     #   #    ## #  ## # #  ## #       #    ### # # ## # #        # #  ## #
#  #   ##  ###   #### #     ##      #   #  # #   # #        #### #    # #  ##  #
###  # #  #  #     ##      # ##  ####         # #  # # #  ##   # ## #    #     #
###   ###  ## #   # #     ## ##  #  ###    ##   #   ##  # #  #   ###    #   # ##
### #  #    ###  ##   # # #   ##  # # ##    #     #       ##   #  ## #### ## # #
# #      ##   # ##  ##      ####### #      ##  #      #   #  #       ##     #  #
################################################################################
