################################################################################
#    #   #   # ###  ###        # # # # #   #  #    # #  ##  ##        ###  ## ##
# ### ###   # # ##    #   # ##  #### ####  #           #              ##  # # ##
#  #  #  #  ## ### ## ## #     #      # #  #  #  #  #   ##  # #   #   #  #   # #
#  #    ## #  #    # #  #    ##  #    ##  ###   #      #   # #  # # ##   # #   #
#   # # # ## ###      # ## #  # #         #       #      ########    #    #    #
###    ##  ##  # # #   #      #     #    #   #  #   # # #      #    # #        #
#   ###    # # #  ## ##     #     ##     ## #  ## #### #   #   # ##     #      #
# ##  # ### #   #    ##  # ## #  #   #  #  # ## #  # #  #   ## ##       # #    #
# #  #    #         #       ## #  #    ##        #    # # ##  #    ####  ##    #
# # #  ## ##   ## ###  # #   ## # ####  #    #  ## #  #     ## #     #  ##    ##
###  #  #####  # ####  # # #  ## #    #    ## #  #         # #  # # #   #  # ###
# #  # # #   ##     ## #         #  #####    # #    ##   ### # ####  #  #      #
# # ##    ##   ##   #  ##           ##        ###   ##   #  #    #  #  # ### ###
#  # #   #  ##  ##   # # ##      #  # #   # #  #           ##    ##    #    #  #
# # #     #    ##   # # # ##  ###  #  ##  ### #  ##         # #  #    # ##   # #
##   ### # ##   ## ##     #  #     # ## #  # ##        ## ##   ## ## #  # #  # #
# #     #  ## #    #  # ## #    ###    # ## ###    ## #     # #   #     #  #   #
###  #   ###      ##  # #  # ### ####   #  ##  ##     #   # ##  ##    #  #    ##
#    #  # ####  #  ###    ######### # ##   #   #### #    #   #   ## #       ## #
#      # #    ##   ##  ##  ###  ##      #           #  # #      ### ## #### ####
# # # #   ##     #   ##   #  #     #    #     #    ###   #  ####  # # ## ## #  #
###  # ###      ## ##  ##  ## #   ##   # # #  #   ##  #  #   ##    ##   ###    #
################################################################################
