################################################################################
################################################################################
################################################################################
################################################################################
################################################################################
################################################################################
################    #####    ###################################################
################    #####    ###################################################
################    #####    ###################################################
################             ###################################################
################    #####    ###################################################
################    #####    ###################################################
################## ######## ####################################################
################## ######## ####################################################
################## ######## ####################################################
################    ####### ######    #######################    ###############
################    ####### ######    #######################    ###############
################    ####### ######    #######################    ###############
################    #######           #######################    ###############
################    ##############    #######################    ###############
################    ##############    #######################    ###############
################## ################# ########################## ################
################## ################# ########################## ################
################## ################# ########################## ################
################    ################ ###############    #####    ###############
################    ####      ###### ##############      ###      ##############
################    ####      ###### ##############      ###      ##############
################                     ##############               ##############
################    ####      #####################      ###      ##############
################    ####### ########################    #####    ###############
########################### ########################## #########################
########################### ########################## #########################
########################### ########################## #########################
########################### ######    #####    #####    ########################
########################### #####      ###      ###      #######################
########################### #####      ###      ###      #######################
###########################                              #######################
#################################      ###      ###      #######################
##################################    #####    #####    ########################
#################################### ################# #########################
#################################### ################# #########################
#################################### ################# #########################
###############      ###      ####    ################ ######    ###############
######      ###      ###      ####    #############      ###      ##############
######      ###      ###      ####    #############      ###      ##############
######                                #############               ##############
######      ###      ###      ####    #############      ###      ##############
###############      ###      ####    #######################    ###############
############################################################### ################
############################################################### ################
############################################################### ################
#############################################################    ###############
#############################################################    ###############
#############################################################    ###############
#############################################################    ###############
#############################################################    ###############
#############################################################    ###############
################################################################################
################################################################################
################################################################################
################################################################################
################################################################################
################################################################################
################################################################################
################################################################################
################################################################################
################################################################################

