################################################################################
################################################################################
################################################################################
################################################################################
####    ##    ##################################################################
####    ##    ##################################################################
####          ##################################################################
####    ##    ##################################################################
############ ###################################################################
############ ###################################################################
############ ###############    ########    ####################################
############ ###############    ########    ####################################
############                    ####        ####################################
############################    #### ###    ####################################
############################## ##### ##### #####################################
############################## ##### ##### #####################################
############################    ##    #### #####################################
############################    ##    #### #####################################
############################          #### #####################################
############################    ##    #### #####################################
############################## ########### #####################################
############################## ########### #####################################
############################## ########### ###    ##############    ############
############################## ########### ###    ##############    ############
############################## ###########                   ###    ############
############################## ###############    ########## ###    ############
############################## ################# ########### ##### #############
############################## ################# ########### ##### #############
################    ########    ##    ########## #########    #### #############
################    ########    ##    ########## #########    #### #############
############                                     #########         #############
############ ###    ########    ##    ####################    ##################
############ ###################################################################
############ ###################################################################
####    ##    ##################################################################
####    ##    ##################################################################
####          ##################################################################
####    ##    ##################################################################
################################################################################
################################################################################
################################################################################
################################################################################
################################################################################
################################################################################
################################################################################
################################################################################
################################################################################
################################################################################
################################################################################
################################################################################

