################################################################################
################################################################################
################################################################################
################################################################################
################################################################################
################################################################################
################################################################################
########      ##########################        #####    #######################
########      ##########################        #####    #######################
########      ##########################        ###        #####################
########      ##########################        ###        #####################
########      ##########################                   #####################
########      ##########################        ###        #####################
########      ##########################        #####    #######################
########      ##########################        #####    #######################
########### ################################ ########## ########################
########### ################################ ########## ########################
########### ################################ ########## ########################
########      ##########################        #####    #######################
########      ###############        ###        ###        ####      ###########
########      ####        ###        ###        ###        ####      ###########
########      ####        ###        ###        ###        ####      ###########
########                                        ###                  ###########
########      ####        ###        ###        ###        ####      ###########
########      ###############        ###        ###        ####      ###########
########      ################### ######        #####    ######### #############
########### ##################### ##################### ########## #############
########### ##################### ##################### ########## #############
########### ##################### ##################### ########## #############
########### #################        ################## #######      ###########
########      ###############        ##############        ####      ###########
########      ###############        ##############        ####      ###########
########      ###############        ##############        ####      ###########
########      ###############        ##############        ####      ###########
########      ###############        ##############        ####      ###########
########      ###############        ##############        ####      ###########
########### #################        ##########################      ###########
########### ##################### ################################ #############
########### ##################### ################################ #############
########### ##################### ################################ #############
########### #################        ##########################      ###########
########      ###############        ###        ###        ####      ###########
########      ###############        ###        ###        ####      ###########
########      ###############        ###        ###        ####      ###########
########      ###############                                        ###########
########      ###############        ###        ###        ####      ###########
########      ###############        ###        ###        ####      ###########
#############################        ##########################      ###########
################################################################################
################################################################################
################################################################################
################################################################################
################################################################################
################################################################################
################################################################################
################################################################################
################################################################################
################################################################################
################################################################################
################################################################################
################################################################################
################################################################################
################################################################################
################################################################################

