################################################################################
## #     #### ##    # # # # #    #     #####   # #   # #    ## ##     #  #     #
# #      #  ##    # ###  ##  # # #    ##            #     #  #  #  ## #      # #
# ## # ###      #  ####     #    ####  ####  # #         #  #   #    #   # ### #
# ## #  #  #       ##           #    #   #####         #  ##   ##  #  #  #  #  #
#    ### #   #      ###  #     ## #  #  ###    ##     # ##    # ## ##     #   ##
#       ##     # ### # ## # ## ##   ## # ##     #    ### #    # # # #     #   ##
#      ## # ###   ## # ###  #    #### # ###   #           #     #    # #    # ##
#   # #      ## ###        ###  ###     ##  ##    ##  ####  # # ###   ## # # # #
# ####  # #  ##  # #    #    #   #  ##  # ## ##   #     # #  #  ##   ##  # #  ##
#  ##    # #### ###  # ##      #     #   ## #     ## # # #  # #      ## # ###  #
##### ####  #   ####     ##      #   ####    ##  ##           ##  # ## ##    # #
# ## # #  ## ## #  #    # #   ###    #      ##     #    #     #       #   #  ###
# #  ##   #  ###    # #  #  #  # # ##  ##     #   ## #  ##          ####  #  ###
######  # ## # # ## ###  #     # ####    # # ###        ## # ####   ##       # #
#      #  ##     # # #      #  #  #  # #   #####  #  #  # ## # #     # ####  # #
#  #     ## # ###   ## # # # ###  ## ## ##   #   #    ##  ## ####      #   # ###
#  ##  #   ##   ####    ##    ##     # ######  #        #          #  # #  ##  #
#     ###      ##   # ###  ## #   # ## #    #        ##    # # #  # #  #   ### #
# #  ### # ### #       # ##     #   ###   #       ## # #  #   #  #       # ##  #
#  # # #  #      ###### ## # # ##    ##   #     ##  ### #   # # # ###   ####   #
#  #       ##       ##  #  # #  ##       # # #    ###    #   #  ###      #  ####
# # #   #    ##     #####    # #   #    #     # # # ## #     ## #   # ##     ###
################################################################################
