################################################################################
#### ## # ##  #        #  ### #  # ###   # #  #      #   #    #  ## # #   #  # #
#   # #    ####### #######       ##    # #          #  ###  ###    ## #   ## # #
# #####     #   ##     ### ### # #  # #  ## # #    #       ##           # ###  #
### #       ##  ##   ## #  ## #     #       # ##    ## #   ##  ###### #      # #
# ## ##     # #  #    ####  # ### ##   ## # ##     #    #  ##   #   #  # #     #
### # ###   # ##    #  #  ##  #  #    ###  #   #    #  ##  #  #         ###    #
#  # #  # #  # # #   #  # # ## #   #  #  ###### # ##    ## ##    ## #  #  #    #
# ### #### # ##  ##    ####    ##  #  #    #   ###    #  #   #   #   #    #    #
#    ###     ##  # ## ## # ## ####   # #   #   #   #   ### #    #      ### # # #
### #  # # # ##  # # ##   # # ##    ### # ## ##    # # # # # ##   # # ####    ##
#  ## #  ## ### # ## ##     #               #  #  #    # ##  ##          #     #
####  ## ###  ### #   # #   # #  #   #  ###   # ### ## # ### # ##        # #   #
#   ##     #   ###       # ######  # #  #  #  # # #   ### ## ##   # ####   #   #
##   #######  ##### #  ### #  ## ## ##     ## #   #   ### # # #  ##   ##  # #  #
#     # ## #   #  #  # #   # #    #### #    #   #    #  #     # ## #   ### # ###
#          #                    ##  #    # #   #      ###    #  # ####  # #  # #
#   ## ## #      ## #     ##         ##  #####   # ##          #    ### #   # ##
#  # #    ##   #          #   #     #   ###     ### #   # # ### #  #### # # ####
#   ## #   ### #   ##  ## #    #   #  #  #  # ### #    #    ## #  # #      #  ##
##  ##  ####  # #   ##   ## ## # #    #  #  ###             # #     # # ## ##  #
#  ##             #      ##    #  #    ##      ####    ##  #  ###   #  #  ##   #
#    #     ###   ##   #  ####  ## #          ##  #  # #    ##  ##    #   # ##  #
################################################################################
